5 15
.....##......#.
.#.##.#.####.#.
.#....#...##.#.
.#.#......S#...
...#.#..####G##
